111111111
100001001
10p000001
100000001
100000001
111111111


