111111111
120000021
10p000001
100200001
100000021
100002001
100000021
111111111
