NO  ./path_to_the_north_texture


SO ./path_to_the_south_texture

WE ./path_to_the_west_texture

EA ./path_to_the_east_texture

F 220,100,0

C 225,30,0



                                 11111   
          11111                  1001
            101                  10011
            101                  10001
   11111111110111111111 111111   10011
   10000000000000110001 1000011110011
   11111110110000011101 110000000001
        1001000000000011 1000011111111
1111111110110000011100011110001
1000000000110000011101000000011111
1111011111111101110001111 1111
1111011111111101110101
11000000110101011100011111
10000000000000000000000001111
1000000000000000110101010000
11000001110101011111011110N0111
11110111 1110101 101111010001
11111111 1111111 111111111111
