1111111111111
1200000000021
1000000000001
10000000p0001
1000000000021
1000020000001
1000000000021
1111111111111
