

       NO  ./path_to_the_north_texture


SO      ./path_to_the_south_texture

WE ./path_to_the_west_texture

EA ./path_to_the_east_texture

F 220,100,0

C 225,30,0

                                 1111
    101   11100001               1001
    101    1001111               10011
    101     10001                10001
   11011111110001111111 111111   10011
   10000000000000110001 1000011110011
   11111110110000011101 110000000001
        1001000000000011 10000111111
1111111110110000011100011110001
1000000000110000011101000000011111
111101111111110111000111111111
1111011111111101110101
11000000110101011100011111
10000000000000000000000001111
10000000000000001101010100001
11000001110101011111011110N0111111
11110111 1110101 101111010001
11111111 1111111 111111111111
