1111111111111
1200000001111
1000000001
10000000W1111
1000000000021
1000020000001
1000000000021
1111111111111
