

       NO  ./path_to_the_north_texture


SO      ./path_to_the_south_texture

WE ./path_to_the_west_texture

EA ./path_to_the_east_texture

F 220,100,0

C 225,30,0



                                 11
            111111               1111
          11100001               1001
     1     1101111               10011
    111     10001                10001
   11011111110001111111 111111  110011
   10000000000000110001 1000011110011
   11111110110000011101 110000000001
        1001000000000011 10000111111
1111111110110000011100011110001
1000000000110000011101000000011111
111101111111110111000111111111
1111011111111101110101
10000000110101011100011111
10111000000000000000000001111
101 1000000000001101010100001
101 1001110101011111011110N0111111
111 1111 1110101 101111010001
      11 1111111 111111111111
