

NO ./images/wallN.xpm

SO ./images/wallS.xpm

WE ./images/wallW.xpm

EA ./images/wallE.xpm

F 200,190,200

C 50,230,100

111111111111111111111111111111111
111111111011000000000000000000001
100000000011000000000111111111111
111101111111110111000000000011111
111101111111110000010100000011111
110000001101010111000000000011111
100000000000000011000000000011111
100000000000000011010100000011111
11000001110101011111011110N011111
111101111111010111011110100011111
111111111111111111111111111111111
