

NO ./images/wall.XPM

SO ./images/wall.XPM

WE ./images/wall.XPM

EA ./images/wall.XPM

F 220,100,0

C 225,30,0


111111
100001
100001
100001
100001
100101
100001
100001
100001
100001
10N001
111111
