

NO ./images/wall.XPM

SO ./images/wall.XPM

WE ./images/wall.XPM

EA ./images/wall.XPM

F 220,100,0

C 20,30,100

        1111111111111111111111111
        1000000000110000000000001
        1011000001110000000000001
        1001000000000000000000001
111111111011000000000000000000001
100000000011000000000111111111111
11110111111111011100000010001
11110111111111000001010010001
11000000110101011100000010001
10000000000000001100000010001
10000000000000001101010010001
11000001110101011111011110N0111
11110111 1110101 101111010001
11111111 1111111 111111111111
