

NO ./images/wallN.xpm

SO ./images/wallS.xpm

WE ./images/wallW.xpm

EA ./images/wallE.xpm

F 220,100,0

C 20,30,100

111111111111
100000000001
10000E000001
100000000001
100000000001
111111111111
