



       NO  ./path_to_the_north_texture


SO      ./path_to_the_south_texture

WE ./path_to_the_west_texture

EA ./path_to_the_east_texture

F 220,100,0

C 225,30,0


111111111111111111111111111111
1N00000000110000011101000000011111
111101111111110111000111111111
1111011111111101110101
10000000110101011100011111
10111000000000000000000001111
101 1000000000001101010100001
101 100111010101111101111000111111
1111111111111111111111111111111111

111111111111111111111111111111111
111111111011000000000000000000001
100000000011000000000111111111111
111101111111110111000000000011111
111101111111110000010100000011111
110000001101010111000000000011111
100000000000000011000000000011111
100000000000000011010100000011111
11000001110101011111011110N011111
111101111111010111011110100011111
111111111111111111111111111111111
