

NO ./images/wall.XPM

SO ./images/wall.XPM

WE ./images/wall.XPM

EA ./images/wall.XPM

F 220,100,0

C 225,30,0


11111111111111111111111111111
11111111110101011100011111111
10111000000000000000000001111
10111000N00000000000000001111
10111000000000000000000001111
10111000000000000000000001111
10111000000000000000000001111
10111000000000000000000001111
10111000000000000000000001111
11111111111111111111111111111
