
NO ./images/wallN.xpm

SO ./images/wallS.xpm

WE ./images/wallW.xpm

EA ./images/wallE.xpm

F 154,250,100

C 54,50,90

                                 11
            111111               1111
          11100001               1001
     1     1101111               10011  
    111     10001                10001     
   11011111110001111111 111111  11001
   10000000000000110001 1000011110011             
   11111110100000011101 110000000001
        1001000S00000011 10000111111
1111111110110000011100011110001
1000000000110000011101000000011111
111101111111110111000111111111
1111011111111101110101
10000000110101011100011111
10111000000000000000000001111
101 1000000000001101010100001
101 100111010101111101111000111111
111 1111 1110101 101111010001
      11 1111111 111111111111
