
NO ./images/wallN.xpm

SO ./images/wallS.xpm

WE ./images/wallW.xpm

EA ./images/wallE.xpm

F 154,250,100

C 54,50,90

111111111111111111111111
100000000000000000110001
100000000000000000110001
100000000000000000110001
100000000000000000110001
111111111000000000000001
100000000000000000000001
10000000001100000N000001
100000000011000000000001
100000000011000000000001
100000000000000000000001
111111111111111111111111
